#############
#w#a#g#m# +n#
#+#+#+#+# ###
#         +t#
#####     #####
#>  +        s#
######### ### #
        #s s s#
        #######